əˈbɔt: month
əˈbatə: months
aˈwan: color
ˈftɔw: four
aˈmntə: West
aˈmerə: inundation
aˈnɔn: we
aˈnɔk: I
ˈirə: to do
ˈjot: father
ˈjɔtə: fathers
ˈɔ: great
aˈnawʃ: oath
aˈʃa: to become many
ˈwot: green
ˈwa: one
ˈwɔp: to be pure
ˈweeb: priest
wˈbaʃ: to become white
ˈwaʃsə: breadth
wˈtah: fruit
ˈbok: servant
ˈboon: bad
ˈpɛ: heaven
ˈpewə: heavens
əbˈra: seed
pˈsitə: nine
ˈpaʃə: half
ˈpitə: bow
ˈmɛ: truth
ˈmɔw: water
ˈmun: to stay, to be stable
ˈmɛ: to love
ˈmer: river bank
ˈmet: ten
ˈneb: lord
ˈnub: gold
ˈnufə: good, beautiful
ˈnatʃhə: tooth
ˈlas: tongue
nˈka: thing
ˈnutə: god
nˈter: gods
nˈtorə: goddess
ˈnutm: sweet
ˈrɔ: mouth
ˈrow: mouths
ˈre: (the god) Re
ˈromə: man
ˈran: name
ˈrɔmpə: year
rmˈpɔwə: years
ˈhob: event
hˈbewə: events
ˈhɔw: day
ˈhe: beginning
ˈhimə: woman
ˈhjɔmə: women
ˈhɔf: snake
ˈhɔ: face
ˈhor: Horus
hˈkɔ: to be hungry
ˈhotp: pleasing
ˈʃɔ: one thousand
ʃˈmun: eight
ˈʃɔmnt: three
hˈrɔw: voice
ˈhon: to approach
hˈrɛ: food offerings
sˈha: to write
ˈsah: scribe
ˈsɔw: six
ˈsaʃf: seven
sˈminə: to establish
ˈsɔn: brother
sˈnew: brothers
ˈsonə: sister
sˈnaw: two
ˈsotp: to choose
ˈsotm: to hear
ˈsoʃə: field
ˈʃmʃə: to worship
ˈʃerə: child
ˈʃɛɛrə: child (f.)
kˈbɔ: to become cool
ˈknnə: to become fat
kˈrɔf: ambush
ˈkjmɛ: gardener
ˈkemə: Egypt
ˈkjow: narrow
ˈkjinə: to find
ˈtɔ: land
ˈtɔʃ: border, province
təˈʃə: neighbor
ˈtaf: spittle
ˈtiw: five
ˈtap: horn
ˈtʃi: to take
tˈba: ten thousand
ˈtorə: hand
ˈtʃo: to say
