ʀaˈbad: month
ʀaˈbuːdaw: months
jaˈwin: color
jifˈdaw: four
jaˈmintit: West
jaˈmirwat: inundation
jaˈnan: we
jaˈnak: I
ˈjiːrit: to do
ˈjaːtij: father
ˈjatjaw: fathers
ˈʕaʀ: great
ʕaˈnaχw: oath
ʕiˈʃiʀ: to become many
ˈwaːʀiɟ: green
ˈwuʕʕuw: one
waˈʕab: to be pure
ˈwiːʕab: priest
waˈbaχ: to become white
ˈwisχat: breadth
wiˈdaħ: fruit
ˈbaːʀak: servant
ˈbaːjin: bad
ˈpit: heaven
ˈpiːwat: heavens
puˈrut: seed
piˈsiːɟaw: nine
ˈpuʃsat: half
ˈpiːɟat: bow
ˈmuʀʕat: truth
ˈmaw: water
ˈmaːn: to stay, to be stable
ˈmirjit: to love
ˈmuːraw: river bank
ˈmuːɟaw: ten
ˈniːbuw: lord
ˈnaːbaw: gold
ˈnaːfir: good, beautiful
ˈnuħɟat: tooth
ˈlis: tongue
nuˈkut: thing
ˈnaːcar: god
naˈcuːraw: gods
naˈcaːrat: goddess
ˈnaːɟim: sweet
ˈraʀ: mouth
ˈraːʀaw: mouths
ˈriːʕuw: (the god) Re
ˈraːmac: man
ˈrin: name
ˈranpat: year
ranˈpawwat: years
ˈhaʀbuw: event
haʀˈbuːwaw: events
ˈharwuw: day
ˈħuːʀit: beginning
ˈħijmat: woman
ħiˈjamwat: women
ˈħafʀaw: snake
ˈħar: face
ˈħaːruw: Horus
ħaˈqar: to be hungry
ˈħaːtip: pleasing
ˈχaʀ: one thousand
χaˈmaːnaw: eight
ˈχamtaw: three
χiˈraw: voice
ˈçaːnan: to approach
çuˈrit: food offerings
ziˈçiʀ: to write
ˈzaçʀaw: scribe
ˈsaʔsaw: six
ˈsafχaw: seven
siˈmiːnit: to establish
ˈsan: brother
saˈnuːwaw: brothers
ˈsaːnat: sister
siˈnuwwaj: two
ˈsaːtap: to choose
ˈsaːɟam: to hear
ˈsaːχat: field
ˈʃimsij: to worship
ˈʃiːrij: child
ˈʃirjit: child (f.)
qaˈbab: to become cool
ˈqinjit: to become fat
qaˈraf: ambush
ˈkaʀmiw: gardener
ˈkuːmat: Egypt
ˈgaːʀiw: narrow
ˈgiːmit: to find
ˈtaʀ: land
taˈʀaʃ: border, province
taʀˈʃij: neighbor
ˈtif: spittle
ˈdiːjaw: five
ˈdib: horn
ˈciːʔ: to take
ɟaˈbaʕ: ten thousand
ˈɟaːrat: hand
ˈɟaːd: to say
